  
************************************************************
*                                                          *
*                                                          *
*                                                          *
*                                                          *
*                                                          *
*                               *                          *
*                               *                          *
*                               *                          *
*                               *                          *
*                               *                          *
*                               *                          *
*                               *                          *
*                               *                          *
*                               *                          *
*                               *                          *
*                               *                          *
*                               *                          *
*                               *                          *
*                               *                          *
*                               *                          *
*                               *                          *
*                               *                          *
*                               *                          *
*                               *                          *
*                               *                          *
*                               *                          *
*                                                          *
*                                                          *
*                                                          *
*                                                          *
*                                                          *
*                                                          *
*                                                          *
*                                                          *
*                                                          *
*                                                          *
*                                                          *
*                                                          *
************************************************************
